#############
#P....#.....#
#.##.#.######
#....#..##..#
###.#########
#K..S.......#
#...?..^....#
#############
