#############
#P.##.#.....#
#..##.#.#####
##...#..DX###
#.#.###.#####
#...S.......#
#...?..E....#
#############
