#################
#P...##......#..#
#.#.##.#######..#
#.#....#.....#..#
#.####.#.###.#.##
#K...#...S.#.#..#
###.#.#####.#.#.#
#...#..?..#..####
#.###.###.#.###.#
#..^....E.......#
#################
