#################
#P.#.##......#..#
#...##.#######..#
##.#...#.....#..#
#.####.#.###.#.##
#....#...S.#.#..#
###.#.#####.#.#.#
#...#..?..#..DX##
#.###.###.#.###.#
#..E....^.......#
#################
