###############
#P.##.#......##
#..##.#####...#
##...#...#....#
#.#.###.#.###.#
#.#.....S...#.#
#.#.#####.#.#.#
#...#..?...DX##
#..E......#...#
###############
