###############
#P....#......##
#.##.#.#####..#
#....#...#....#
###.###.#.###.#
#K#.....S...#.#
#.#.#####.###.#
#...#..?...##.#
#..^......#...#
###############
